MMMMMMMMMMMMMMMMMMMMMMMMMMMMMMMMMMMMMMMMMMMMMMMMMMMMMMMMMMMMMMMMMMMMMMMMMMMMMMM
M                                                                             M
M                                                                             M
M                                                                             M
M                                                                             M
M            MMMMMMMMMMMMMMMMMMMMMMMMMMMMMMMMMMMMMMMMMMMMMMMMMMMMMM           M
M                                                                             M
M                                                                             M
M                                                                             M
M                                                                             M
M                                                                             M
M                                                                             M
M                                                                             M
M                                                                             M
M            MMMMMMMMMMMMMMMMMMMMMMMMMMMMMMMMMMMMMMMMMMMMMMMMMMMMMM           M
M                                                                             M
M                                                                             M
M                                                                             M
M                                                                             M
M                                                                             M
MMMMMMMMMMMMMMMMMMMMMMMMMMMMMMMMMMMMMMMMMMMMMMMMMMMMMMMMMMMMMMMMMMMMMMMMMMMMMMM@