MMMMMMMMMMMMMMMMMMMMMMMMMMMMMMMMMMMMMMMMMMMMMMMMMMMMMMMMMMMMMMMMMMMMMMMMMMMMMMM
M                                                                             M
M                                                                             M
M                                                                             M
M             MMMMMMMMMMMMMMMMMMMMMMMMMMMMMMMMMMMMMMMMMMMMMMMMMMM             M
M                                     M      M                                M
M                                     M      M                                M
M                                     M      M                                M
M                                                                             M
M                                                                             M
M                                                                             M
M                                     M      M                                M
M                                     M      M                                M
M                                     M      M                                M
M             MMMMMMMMMMMMMMMMMMMMMMMMMMMMMMMMMMMMMMMMMMMMMMMMMMM             M
M                                                                             M
M                                                                             M
M                                                                             M
M                                                                             M
M                                                                             M
MMMMMMMMMMMMMMMMMMMMMMMMMMMMMMMMMMMMMMMMMMMMMMMMMMMMMMMMMMMMMMMMMMMMMMMMMMMMMMM@